########################################
#                                      #
#                                      #
#    ####             #####    ####    #
#       #                      #       #
#       #                      #       #
#                                      #
#                                      #
#                              #       #
#                 SqqQ         #       #
#       #                              #
#       #                              #
#                                      #
#                                      #
#       #                      #       #
#       #                      #       #
#    ####    #####          ####       #
#                                      #
#                                      #
########################################
